111111111111111111111111111111
100000000000000000000000000001
100000000000000000000000000001
111111D1111111111111111D111111
100000000001000001000000000001
100000000001000001000000000001
100000000001000001000000000001
10000000000D00000D000000000001
100000000001000001000000000001
100000000001000001000000000001
100000000001000001000000000001
100000000001000001000000000001
100000000001000001000000000001
111111D1111111111111111D111111
100000000000000000000000000001
100000000000000000000000000001
100000000000000000000000000001
100000000000000000000000000001
100000000000000EE000000000001
111111111111111111111111111111
