1111111111111111111111111111
1000000000000110000000000001
1000110000000110000011000001
1000110000000110000011000001
1000000000000110000000000001
11111D1111111111111111D11111
1000000000000000000000000001
1000110000000000000011000001
1000110000000000000011000001
1000000000000000000000000001
1000000000000000000000000001
1000000000000000000000000001
1000110000000000000011000001
1000110000000000000011000001
11111111D1111111111D11111111
1000000010000000010000000001
100000000D00000000D000000001
1000000010000000010000000001
1000000010000000010000000001
1111111111111111111111EE1111
