1111111111111EE1111111111111
1000000000000000000000000001
1000001110000000001110000001
1000001000000000001000000001
1000000000000000000000000001
1000110000000000000000110001
1000100000000000000000010001
1000000000000000000000000001
1000000011000000001100000001
1000000000000000000000000001
1000000000000000000000000001
1000000011000000001100000001
1000100000000000000000010001
1000110000000000000000110001
1000000000000000000000000001
1000000000000000000000000001
1000000110000000011000000001
1000000100000000001000000001
1000000000000000000000000001
1000000000000000000000000001
1000000000000000000000000001
1111111111111111111111111111
