1111111111111111111111111111
1000000000000000000000000001
1000000110000000011000000001
1000000100000000001000000001
11111D11111111111111111D1111
1000000001000100001000000001
1001110001000100001000111001
1000010001000100001000100001
1000010001000100001000100001
100001000D000D0000D000100001
1000010001000000001000100001
1001110001001111001000111001
1000000001000000001000000001
11111D11111111111111111D1111
1000000000000000000000000001
1000000110000000011000000001
1000000100001111001000000001
1000000100000000001000000001
1000000000000000000000000001
1111111111111EE1111111111111
