1111111111111111111111111111
1000000000000000000000000001
1000000000000000000000000001
1000000000000000000000000001
1000011D11000000000011D11001
1000010001000000000010000001
1000010001111111111110000001
1000010000000000000000000001
1000010000000000000000000001
1000011D11000000000011D11001
1000000000000000000000000001
1000000000000000000000000001
1000000000000000000000000001
1000000011100000001110000001
1000000010000000001000000001
1000000010000000001000000001
1000000011100000001110000001
1000000000000000000000000001
1000000000000000000000000001
1111111111111EE1111111111111
