1111111111111111111111111111
1000000001000000001000000001
1000000001000000001000000001
1000000001000000001000000001
1001100001000000001000110001
1001100001000000001000110001
1000000001000000001000000001
1000000001000000001000000001
1000000001000000001000000001
1000000001000000001000000001
100000000D00000000D000000001
1000000001000000001000000001
1000000001000000001000000001
1000000001000110001000000001
1000000001000110001000000001
1000000001000000001000000001
1000000001000000001000000001
1000000001000000001000000001
1000000001000000001000000001
1111111111111111111111EE1111
