111111111111111111111111111111
100000000000000000000000000001
100000001100000000001100000001
111111D1111111111111111D111111
100000000001000001000000000001
100111100001000001000111100001
100100000001000001000000100001
10010000000D00000D000000100001
100100000001000001000000100001
100111100001000001000111100001
100000000001000001000000000001
100000111101000001011110000001
100000000001000001000000000001
111111D1111111111111111D111111
100000000000000000000000000001
100000011000000000001100000001
100000010000111100000100000001
100000010000000000000100000001
100000000000000000000000000001
111111111111111EE1111111111111
