1111111111111111111111111111
1P0000000000000000000000001
1000111000000000000111000001
1000100000000000000001000001
1000111000000000000111000001
1000000000000000000000000001
1000000000000000000000000001
1000000000000000000000000001
1000000000000000000000000001
1000000000000000000000000001
1000000000000000000000000001
1000000000000000000000000001
1000000000000000000000000001
1000000000000000000000000001
1000000000000000000000000001
1000111000000000000111000001
1000100000000000000001000001
1000111000000000000111000001
10000000000000000000000000X1
1111111111111111111111111111
