1111111111111111111111111111
1000000000000000000000000001
1000111111111D11111111110001
1000100000000000000000010001
1000100000011111100000010001
1000000000000000000000000001
11111D11011100000011101D1111
1000000001000000001000000001
1001110000000000000001110001
1000010000000000000001000001
1000010000000000000001000001
1000010000000000000001000001
1001110000000000000001110001
1000000001000000001000000001
11111D11011100000011101D1111
1000000000000000000000000001
1000100000011111100000010001
1000100000000000000000010001
1000000000000000000000000001
11111111111111E1111111111111
