1111111111111EE1111111111111
1000000000000000000000000001
1000111100000000111100000001
11111D111111111D111111D11111
1000000000010000001000000001
1001110000010110001000111001
1000010000010000001000100001
100001111111111D111110000001
1000000000010000001000001101
10011111000D000000D000010001
1000000100010000001000000101
100000010001110D111100000101
1001110100000000000001111001
1000010000010000001000000001
11111D111111111111111D111111
1000000000010000000000000001
1001111000010000111100111001
1001000000010000000100100001
1001001110000000000100000001
1000000010001111000011110001
1000000000000000000000000001
1111111111111111111111111111
