1111111111111111111111111111
1000000000000000000000000001
1000011110000000111100000001
11111D111111111D111111D11111
1000000000010000001000000001
1001111000010000001001110001
1001000000010000001000010001
100100111111111D111100000001
1000000000010000001000111001
10011111000D000000D000010001
1000000100010000001000000101
100000010001111D111100000101
1001110100000000000001111001
1000010000010000001000000001
11111D111111111111111D111111
1000000000010000000000000001
1001111000010000111100111001
1001000000010000000100100001
1001001110000000000100000001
1000000010001111000000000001
1000000000000000000000000001
1111111111111EE1111111111111
