1111111111111111111111111111
1000000000000000000000000001
1000000000000000000000000001
1000000000000000000000000001
11111D11111111111111111D1111
1000000001000100001000000001
1000000001000100001000000001
1000000001000100001000000001
1000000001000100001000000001
100000000D000D0000D000000001
1000000001000000001000000001
1000000001000000001000000001
1000000001000000001000000001
11111D11111111111111111D1111
1000000000000000000000000001
1000000000000000000000000001
1000000000000000000000000001
1000000000000000000000000001
1000000000000000000000000001
1111111111111EE1111111111111
