1111111111111111111111111111
1000000000000000000000000001
1000000110000000011000000001
11111D111111111D111111D11111
1000000000010000001000000001
1001110000010000001000111001
1000010000010000001000100001
11111D111111111D111111D11111
1000000000010000001000000001
100001111D000000D11110000001
1000010000010000001000100001
1000010000010000001000100001
100111000001111D111000111001
1000000000000000000000000001
11111D111111111111111D111111
1000000000010000000000000001
1001111000010000111100000001
1001000000010000000100111001
1001000000000000000100100001
1000000000000000000000000001
1000000000000000000000000001
1111111111111EE1111111111111
