1111111111111111111111111111
1000000000000000000000000001
1000000000000000000000000001
11111D111111111D111111D11111
1000000000010000001000000001
1000000000010000001000000001
1000000000010000001000000001
11111D111111111D111111D11111
1000000000010000001000000001
1000000000010000001000000001
1000000000010000001000000001
11111D111111111D111111D11111
1000000000000000000000000001
1000000000000000000000000001
11111D111111111111111D111111
1000000000010000000000000001
1000000000010000000000000001
1000000000010000000000000001
1000000000010000000000000001
1000000000000000000000000001
1000000000000000000000000001
1111111111111EE1111111111111
