1111111111111111111111111111
1000000000000000000000000001
1000000000000000000000000001
1000000000000000000000000001
1000000000000000000000000001
1000000011111D11111100000001
1000000010000000001000000001
1000000010000001100100000001
1000000010000001100100000001
10000000D0000000000D0000000E
10000000D0000000000D0000000E
1000000010011000001000000001
1000000010011000001000000001
1000000010000000001000000001
10000000111111D1111100000001
1000000000000000000000000001
1000000000000000000000000001
1000000000000000000000000001
1000000000000000000000000001
1111111111111111111111111111
